1,1,1,1,1,1,1,1,1,1,1,1
1,33,33,291,1,1,1,1,1,1,1,1
1,65,101,99,1,1,32,1,289,1,1,1
1,65,67,1,1,1,1,1,1,1,1,1
0,65,67,1,1,32,32,32,32,1,1,1
1,65,67,1,1,32,1,1,10,11,1,1
1,97,99,1,1,32,32,1,42,43,1,1
1,1,1,1,1,230,231,32,1,1,1,1
1,1,1,1,1,1,1,1,1,1,1,1
1,1,1,1,1,1,1,1,1,1,1,1
