124,222,125,125,222,125,125,222,125,125,54,54,54,54,54,54,54,54,54,54,54,54,54,54,54,54,54,54,54,54,54,54,54,54,54,54,50,50,50,50,50,50,50,50,50,50,50,50,50,50,50,50,50,50,50,50,50,50,50,50,50,50,50,50,50,50,50,50,50,50,50,50,50,50,50,50,50,50,50,50,50,50,50,50,50,50,50,50,50,50,50,50,41,54,54,38,41,54,54,38,41,54,54,73,50,50,50,50,50,50,50,50,50,50,50,50,50,50,50,50,50,50,50,50,50,50,50,50
140,238,141,141,238,141,141,238,141,141,12,14,14,14,3,4,5,13,13,13,13,41,54,54,73,50,50,50,50,50,50,50,50,50,50,50,50,50,50,50,50,50,50,50,50,50,50,0,80,81,81,82,2,50,50,50,50,50,50,50,50,50,50,50,50,50,50,50,50,50,50,50,50,50,50,50,50,50,50,50,50,50,50,50,50,50,50,50,50,50,50,50,41,54,54,38,41,54,54,38,41,54,54,73,50,50,50,50,50,50,50,50,50,50,50,50,50,50,50,50,50,50,50,50,50,50,50,50
156,254,157,157,254,157,157,254,157,157,28,30,30,30,19,20,21,29,29,29,29,41,54,54,57,50,50,50,50,50,50,50,50,50,50,50,50,50,50,50,50,50,50,50,50,50,0,48,17,17,17,17,49,2,50,50,50,50,50,50,50,50,50,50,50,50,50,50,50,50,50,50,50,50,50,50,50,50,50,50,50,50,50,50,50,50,50,50,50,50,50,50,41,54,54,38,41,54,54,38,41,54,54,73,50,50,50,50,50,50,50,50,50,50,50,50,50,50,50,50,50,50,50,50,50,50,50,50
172,173,173,173,173,173,173,173,173,173,44,46,46,46,35,36,37,45,45,45,45,41,54,54,57,0,1,1,1,1,1,1,1,1,1,2,50,50,50,50,50,50,50,50,50,0,48,161,161,161,161,17,17,18,50,50,50,50,50,50,50,50,50,50,50,50,50,0,1,1,1,1,1,2,50,50,50,50,50,50,50,50,50,0,1,1,1,1,2,50,50,50,124,125,126,127,41,54,54,38,124,125,126,127,50,50,50,50,50,50,50,50,50,50,50,50,50,50,50,50,50,50,50,50,50,50,50,50
50,50,50,50,50,50,50,0,1,1,146,103,103,144,144,144,144,144,144,145,145,41,54,54,57,16,161,161,161,161,161,161,161,161,161,49,2,0,2,50,50,50,50,50,50,16,161,161,161,161,161,161,17,18,50,50,50,50,50,50,50,50,50,50,50,50,50,16,161,161,161,161,161,18,50,50,50,50,50,50,50,50,0,48,161,161,161,161,18,50,50,50,140,141,142,143,41,54,54,73,140,141,142,143,50,50,50,50,50,50,50,50,50,50,50,50,50,50,50,50,50,50,50,50,50,50,50,50
50,50,50,50,50,50,50,16,17,17,103,103,103,103,144,144,144,144,144,145,145,41,54,54,73,16,161,161,161,161,161,161,161,161,161,65,34,32,34,50,50,50,50,50,50,16,161,161,161,161,161,161,17,18,50,50,50,50,50,50,50,50,50,50,50,50,50,16,161,161,161,161,161,18,50,50,50,50,50,50,50,50,16,161,161,161,161,161,18,50,50,50,140,93,94,143,124,125,126,50,140,93,94,143,50,50,50,0,1,1,2,50,50,50,50,50,50,50,50,50,50,50,50,50,50,50,50,50
50,50,50,0,1,2,50,16,17,17,17,103,133,103,144,144,144,148,144,145,145,41,54,54,73,16,161,65,96,97,97,98,64,161,161,18,50,50,0,1,2,50,50,50,50,16,161,161,161,161,161,161,65,34,50,50,50,50,50,50,50,50,50,50,50,50,50,16,161,161,161,161,161,49,2,50,50,50,50,50,50,50,16,161,161,161,161,161,18,50,50,50,156,157,158,159,140,141,142,143,156,157,158,159,50,50,0,48,161,161,49,1,2,50,50,50,50,50,50,50,50,50,50,50,50,50,50,50
50,50,50,16,128,18,50,32,33,64,103,103,103,103,144,144,144,144,144,145,145,41,54,54,73,16,161,18,50,50,50,50,16,161,161,18,50,0,48,161,49,80,81,2,50,32,64,17,161,161,17,65,34,50,50,50,50,50,50,50,50,50,50,50,50,50,50,32,64,161,161,161,161,161,18,50,50,50,50,50,50,50,16,161,161,161,161,161,18,50,50,50,172,173,174,175,140,93,94,143,172,173,174,175,0,1,48,161,161,161,161,161,49,1,1,1,1,1,1,1,1,1,2,50,50,50,50,50
50,50,50,32,33,34,50,50,50,32,33,33,33,64,160,160,65,33,33,33,33,41,54,54,73,16,161,18,50,50,50,50,16,161,161,18,50,16,161,147,161,161,161,49,2,0,48,17,161,161,17,18,50,50,50,50,50,50,50,50,50,50,50,50,50,50,50,50,32,64,161,161,161,161,18,50,50,50,50,50,50,50,16,161,161,161,161,161,18,50,50,50,50,50,50,50,156,157,158,159,50,50,50,0,48,161,161,161,65,33,64,161,161,161,161,161,161,161,161,161,161,161,49,2,50,50,50,50
50,50,50,50,50,50,50,50,50,50,50,50,50,16,160,160,18,50,50,50,50,124,125,126,127,16,161,18,50,50,50,50,16,161,161,18,50,16,161,161,161,161,161,161,49,48,17,17,161,161,17,49,81,2,0,2,50,50,50,50,50,50,50,50,50,50,50,50,50,16,161,161,65,33,34,50,50,50,50,50,50,50,16,161,161,161,161,161,18,50,50,50,50,50,50,50,172,173,174,175,50,50,50,16,17,161,65,33,34,50,32,33,64,161,161,161,161,161,161,161,161,161,161,18,50,50,50,50
50,50,50,50,50,50,50,50,50,50,50,50,50,16,160,160,18,50,50,50,50,140,141,142,143,16,161,18,50,50,50,50,16,161,161,18,50,16,161,161,17,161,161,161,161,161,161,161,161,161,17,161,161,49,48,49,2,50,50,50,50,50,50,50,50,50,50,50,50,32,64,161,49,1,1,1,1,1,1,1,2,50,32,64,161,161,161,65,34,50,50,50,50,50,0,1,1,1,1,1,1,1,1,48,161,65,34,50,50,50,50,50,16,161,161,65,96,97,98,64,161,161,161,18,50,50,50,50
50,50,50,50,50,50,50,50,50,50,50,50,50,16,160,160,18,50,50,50,50,140,93,94,143,16,160,18,50,50,50,50,16,161,161,18,50,32,33,64,17,17,161,161,161,161,161,161,161,161,161,161,161,161,161,161,49,2,50,50,50,50,50,0,1,1,80,81,82,1,48,161,161,161,161,161,161,161,161,161,49,2,50,32,64,161,161,18,50,50,50,50,50,50,16,161,161,161,161,161,161,161,161,161,161,49,2,50,50,50,50,50,32,64,161,18,50,50,50,32,64,161,161,18,50,50,50,50
50,50,50,50,50,50,50,50,50,50,50,50,50,16,160,160,18,50,50,50,50,156,157,158,159,16,160,49,2,50,50,50,16,161,161,18,50,50,50,32,33,33,33,33,33,33,33,33,33,33,64,17,17,17,161,161,17,18,50,50,50,50,50,16,161,161,161,161,161,161,161,161,161,65,33,64,161,161,161,161,161,49,2,50,16,161,161,18,50,50,50,50,50,50,16,161,65,96,98,33,64,161,65,64,17,17,49,2,50,50,50,50,50,16,161,18,50,50,50,50,16,161,161,18,50,50,50,50
50,50,50,50,50,50,50,50,50,50,50,50,50,16,160,160,18,50,50,50,50,172,173,174,175,16,160,160,18,50,50,50,16,161,161,18,50,0,1,1,2,50,50,50,50,50,50,50,50,50,16,17,17,17,161,161,17,18,50,50,50,50,0,48,161,161,161,161,161,65,33,33,33,34,50,32,33,64,161,161,161,161,18,50,16,161,161,18,50,50,50,50,50,50,16,161,18,50,50,50,16,161,18,32,64,17,17,49,1,1,2,50,50,16,161,18,50,50,50,50,16,161,161,49,2,50,50,50
50,50,50,50,50,50,50,50,50,50,50,50,50,16,160,160,18,50,50,50,50,50,50,50,0,48,160,160,18,50,50,50,16,161,161,18,50,16,161,161,18,50,50,50,50,50,50,50,50,50,16,17,17,17,161,161,17,18,50,50,50,50,16,161,161,161,65,33,33,34,50,50,50,50,50,50,50,32,64,161,161,161,18,50,16,161,161,18,50,50,50,50,50,50,16,161,18,50,50,50,16,161,18,50,32,64,17,17,17,161,18,50,50,16,161,18,50,50,50,50,16,161,161,161,18,50,50,50
50,50,50,0,1,82,1,1,1,1,1,1,1,48,160,160,49,1,1,1,1,1,1,2,16,160,160,160,18,50,50,50,16,161,161,18,50,16,161,161,18,50,50,50,50,50,50,50,50,50,16,17,17,17,161,161,17,18,50,50,50,50,16,161,161,65,34,50,50,50,50,50,50,50,50,50,50,50,16,161,161,161,18,50,16,161,161,18,50,50,50,50,50,50,16,161,18,50,50,50,16,161,18,50,50,32,33,33,64,161,18,50,50,16,161,18,50,50,50,50,16,161,161,161,18,50,50,50
50,50,50,16,160,160,160,160,160,160,160,160,160,160,160,160,160,160,160,160,160,160,145,18,16,160,160,160,18,50,50,50,16,161,161,18,50,16,161,161,18,50,50,50,50,50,50,50,50,50,16,17,17,17,161,161,17,18,50,50,50,50,16,161,161,18,50,50,50,50,50,50,0,1,1,2,50,50,16,161,161,161,18,50,16,161,161,18,50,50,50,50,50,50,16,161,18,50,50,50,16,161,49,1,2,50,50,50,16,161,18,50,50,16,161,18,50,50,50,50,16,161,161,161,18,50,50,50
50,50,50,16,160,160,160,160,160,160,160,160,160,160,160,160,160,160,160,160,160,160,145,49,48,115,160,160,18,50,50,50,16,161,161,18,50,16,161,161,18,50,50,50,50,50,50,50,50,50,32,33,33,64,161,161,17,18,50,50,50,50,16,161,161,18,50,50,0,1,1,1,48,161,161,18,50,50,32,64,161,161,18,50,16,161,161,49,1,2,50,50,50,50,16,161,18,50,50,50,16,161,161,161,49,2,50,50,16,161,49,1,2,16,161,18,50,50,50,50,16,161,161,161,49,2,50,50
50,50,50,16,160,160,160,160,160,160,160,160,160,160,160,160,65,33,33,33,64,160,160,160,160,160,160,160,18,50,50,50,16,161,161,18,50,16,161,161,18,50,50,50,50,50,50,50,50,50,50,50,50,16,161,161,17,18,50,50,50,50,16,161,161,18,50,50,16,161,161,161,161,161,161,18,50,50,50,16,161,161,49,80,48,161,161,161,161,18,50,50,50,50,16,161,18,50,50,50,32,33,64,161,161,18,50,50,16,161,161,161,49,48,161,18,50,50,50,50,16,161,161,161,65,34,50,50
50,50,50,32,33,33,33,96,97,97,97,97,98,33,33,33,34,50,50,50,16,160,160,160,160,160,160,65,34,50,50,50,16,161,161,18,50,16,161,161,18,50,50,50,50,50,50,50,50,50,50,50,50,16,161,161,17,18,50,50,50,50,16,161,65,34,50,50,16,161,161,161,161,161,161,18,50,50,50,16,161,161,161,161,161,161,161,161,161,49,1,1,1,1,48,161,18,50,50,50,50,50,32,64,161,49,2,50,16,161,116,116,161,161,65,34,50,50,50,50,16,161,161,65,34,50,50,50
50,50,50,50,50,50,50,50,50,50,50,50,50,50,50,50,50,50,50,50,32,33,33,33,33,33,33,34,50,50,50,50,16,161,161,18,50,16,161,161,18,50,50,50,50,50,50,50,50,50,50,50,50,32,64,161,17,18,50,50,50,50,16,161,18,50,50,50,16,161,161,161,161,161,161,18,50,50,50,16,161,161,161,161,161,161,161,161,161,161,161,161,161,161,161,161,18,50,50,50,50,50,50,16,161,161,18,50,16,161,65,33,33,33,34,50,50,50,50,50,16,161,161,18,50,50,50,50
50,50,50,50,50,50,50,50,50,50,50,50,50,50,50,50,50,50,50,50,50,50,50,50,50,50,50,50,50,50,0,1,48,161,161,18,50,16,161,161,18,50,50,50,50,50,50,50,50,50,50,50,50,0,48,65,33,34,50,50,50,50,16,161,49,2,50,50,32,64,161,161,161,161,161,18,50,50,50,32,33,33,64,161,161,161,161,161,161,161,161,161,161,161,161,161,18,50,50,50,50,50,50,32,64,161,18,50,16,161,18,50,50,50,50,50,50,50,50,50,16,161,161,18,50,50,50,50
50,50,50,50,50,50,50,50,50,50,50,50,50,50,50,50,50,50,50,50,50,50,50,50,50,50,50,50,50,50,16,161,161,161,161,18,50,16,161,161,18,50,50,50,50,50,50,50,50,50,50,50,50,16,161,18,50,50,50,50,50,50,32,64,161,18,50,50,50,16,161,161,161,161,161,18,50,50,50,0,1,1,48,161,161,161,161,161,161,65,33,33,33,33,64,161,18,50,50,50,50,50,50,50,16,161,18,50,16,161,18,50,50,50,50,50,50,50,50,0,48,161,161,18,50,50,50,50
50,50,50,50,50,50,50,50,50,50,50,50,0,80,81,82,2,50,50,50,50,50,50,50,50,50,50,50,0,1,48,161,65,33,33,34,50,16,161,161,18,50,0,1,1,1,1,1,1,1,1,1,2,16,161,18,50,50,50,50,50,50,50,16,161,18,50,50,50,32,33,33,33,33,33,34,50,50,50,16,161,161,161,161,161,161,161,161,161,18,50,50,50,50,16,161,18,50,50,50,50,50,50,50,16,161,18,50,16,161,18,50,0,1,1,1,1,2,50,16,161,161,161,18,0,2,50,50
50,50,50,50,50,50,50,50,50,50,50,50,32,96,97,98,34,50,50,50,50,50,50,50,50,50,50,50,16,161,161,161,18,50,50,50,50,16,161,161,18,50,16,161,161,161,161,161,161,161,161,161,18,16,161,49,1,1,1,1,1,1,1,48,161,18,50,50,50,50,50,50,50,50,50,50,50,50,50,16,161,161,161,161,161,161,161,161,161,18,50,50,50,50,16,161,49,1,1,1,1,1,1,1,48,161,49,1,48,161,18,50,16,161,161,161,161,18,50,16,161,161,161,18,16,49,1,1
50,50,50,50,50,50,50,50,50,50,50,50,50,50,50,50,50,50,50,50,50,50,50,50,50,50,50,50,16,161,65,33,34,50,50,50,50,16,161,161,49,1,48,161,161,161,161,161,161,161,161,161,49,48,161,161,161,161,161,161,161,161,161,161,161,18,50,50,50,50,50,50,50,50,50,50,50,50,50,16,161,65,33,64,161,161,161,161,161,18,50,50,50,50,16,161,161,161,161,161,161,161,161,161,161,161,161,161,161,161,18,50,16,161,161,161,161,49,81,48,161,161,161,18,16,65,33,33
50,50,0,81,81,81,82,82,82,81,80,80,1,1,81,81,82,1,1,1,1,1,80,81,82,1,2,50,16,161,18,50,50,50,50,50,50,16,161,17,161,161,161,161,161,161,161,161,161,161,161,161,161,161,161,161,161,161,161,161,161,161,161,161,161,18,50,50,50,50,50,50,50,50,50,50,50,50,0,48,161,18,50,32,64,161,161,65,33,34,50,50,50,50,32,33,33,33,33,33,33,33,33,33,33,33,33,33,33,33,34,50,16,161,161,161,161,161,161,161,161,161,161,18,32,34,50,50
50,50,16,161,161,161,161,161,161,161,161,161,161,161,161,161,161,161,161,161,161,161,161,161,161,161,18,0,48,161,18,50,50,50,50,50,50,16,161,161,161,65,64,161,161,161,161,161,161,161,161,161,65,33,33,33,33,33,33,33,33,33,33,64,161,18,50,50,50,50,50,50,50,50,50,50,50,0,48,161,161,18,50,50,16,161,161,18,50,50,50,50,50,50,50,50,50,50,50,50,50,50,50,50,50,50,50,50,50,50,50,50,16,161,161,161,161,65,33,64,161,161,161,18,50,50,50,50
50,0,48,161,161,161,161,161,161,161,65,33,33,33,33,33,33,33,33,33,33,33,33,33,64,161,49,48,161,161,18,50,50,50,50,50,50,16,161,161,161,18,16,161,161,161,161,161,161,161,161,161,18,50,50,50,50,50,50,50,50,50,50,16,161,49,1,2,50,50,50,50,50,50,50,50,0,48,161,161,161,18,50,50,16,161,161,18,50,50,50,50,50,50,50,50,50,50,50,50,50,50,50,50,50,50,50,50,50,50,50,50,16,161,161,161,161,18,50,16,161,161,161,18,50,50,50,50
50,16,161,161,65,33,33,33,33,33,34,50,50,50,50,50,50,50,50,50,50,50,50,50,16,161,161,161,161,161,18,50,50,50,50,50,50,16,161,161,161,18,32,33,33,33,33,33,33,33,33,33,34,50,50,50,50,50,50,50,50,50,50,16,161,161,161,18,50,50,50,50,0,1,1,1,48,161,161,161,65,34,50,50,16,161,161,18,50,50,50,50,50,50,50,50,50,50,50,50,50,50,50,50,50,50,50,50,50,50,50,50,32,33,33,33,33,34,50,16,161,161,161,18,50,50,50,50
50,16,161,161,18,50,50,50,50,50,50,50,50,50,50,50,50,50,50,50,50,50,50,50,16,161,161,161,161,161,18,50,50,50,50,50,50,16,161,161,161,18,50,50,50,50,50,50,50,50,50,50,50,50,50,50,50,50,50,50,50,50,50,16,161,161,161,49,80,81,81,82,48,161,161,161,161,161,65,33,34,50,50,50,16,161,161,18,50,50,50,50,50,50,50,50,50,50,50,50,50,50,50,50,50,50,50,50,50,50,50,50,50,50,50,50,50,50,50,32,64,161,161,18,50,50,50,50
50,16,161,161,18,50,50,50,50,50,50,50,50,50,50,50,50,50,50,50,50,50,50,50,16,161,65,33,33,33,34,50,50,0,1,1,1,48,161,161,65,34,50,50,50,50,50,50,50,50,50,50,50,50,50,50,50,50,50,50,50,50,50,32,64,161,161,161,161,161,161,161,161,161,161,161,161,65,34,50,50,50,0,1,48,161,161,49,1,2,50,50,50,50,50,50,50,50,50,50,50,50,50,50,50,50,50,0,1,1,1,1,2,50,50,50,50,50,50,50,16,161,161,49,80,1,2,50
50,16,161,161,18,50,50,50,50,50,50,50,50,50,50,50,50,50,50,0,80,82,2,50,16,161,49,1,1,1,1,1,1,48,161,161,161,161,161,161,18,50,50,50,50,50,50,50,50,50,50,50,50,50,50,50,50,50,50,50,50,50,50,50,32,33,33,64,161,161,161,161,65,33,33,33,33,34,50,50,50,50,16,161,161,161,161,161,161,18,50,50,50,50,50,50,50,50,50,50,50,50,50,50,50,50,0,48,161,161,161,161,49,1,1,1,1,2,50,50,16,161,161,65,98,33,34,50
50,32,64,161,49,81,81,81,81,81,81,81,81,1,1,1,1,1,1,48,161,161,49,1,48,161,161,161,161,161,161,161,161,161,161,161,161,161,161,65,34,50,50,50,50,50,50,50,50,50,50,50,50,50,50,50,50,50,50,50,50,50,50,50,50,50,50,32,33,33,33,33,34,50,50,50,50,50,50,50,50,50,16,161,161,161,161,161,161,18,50,50,50,50,50,50,50,50,50,50,50,50,50,50,50,50,16,161,161,161,161,161,161,161,161,161,161,18,50,50,16,161,161,18,50,50,50,50
50,50,16,161,161,161,161,161,161,161,161,161,161,161,161,161,161,161,161,161,161,161,161,161,161,161,161,161,161,161,161,161,161,161,65,33,33,33,33,34,50,50,50,50,50,50,50,50,50,50,50,50,50,50,50,50,50,50,50,50,50,50,50,50,50,50,50,50,50,50,50,50,50,50,50,50,50,50,50,50,50,50,16,161,161,161,161,161,161,18,50,50,50,50,50,50,50,50,50,50,50,50,50,50,50,50,16,161,161,161,161,161,161,161,161,161,161,18,50,50,16,161,161,18,50,50,50,50
50,50,32,33,96,97,97,98,33,33,33,96,97,97,97,98,96,97,97,97,97,97,98,33,33,96,33,33,33,33,33,33,33,33,34,50,50,50,50,50,50,50,50,50,50,50,50,50,50,50,50,50,50,50,50,50,50,50,50,50,50,50,50,50,50,50,50,50,50,50,50,50,50,50,50,50,50,50,50,50,50,50,16,161,161,161,161,161,161,18,50,50,50,50,50,50,50,50,50,50,50,50,50,50,50,50,32,64,161,161,161,161,65,33,64,161,161,18,50,50,16,161,161,18,50,50,50,50
50,50,50,50,50,50,50,50,50,50,50,50,50,50,50,50,50,50,50,50,50,50,50,50,50,50,50,50,50,50,50,50,50,50,50,50,50,50,50,50,50,50,50,50,50,50,50,50,50,50,50,50,50,50,50,50,50,50,50,50,50,50,50,50,50,50,50,50,50,50,50,50,50,50,50,50,50,50,50,50,50,50,16,161,161,161,161,161,161,18,50,50,50,50,50,50,50,50,50,50,50,50,50,50,50,50,50,32,33,33,33,33,34,50,16,161,161,49,1,1,48,161,161,18,50,50,50,50
50,50,50,50,50,50,50,50,50,50,50,50,50,50,50,50,50,50,50,50,50,50,50,50,50,50,50,50,50,50,50,50,50,50,50,50,50,50,50,50,50,50,50,50,50,50,50,50,50,50,50,50,50,50,50,50,50,50,50,50,50,50,50,50,50,50,50,50,50,50,50,50,50,50,50,50,50,50,50,50,50,50,32,33,33,33,33,33,33,34,50,50,50,50,50,50,50,50,50,50,50,50,50,50,50,50,50,50,50,50,50,50,50,50,16,161,161,161,161,161,161,161,161,18,50,50,50,50
50,50,50,50,50,50,50,50,50,50,50,50,50,50,50,50,50,50,50,50,50,50,50,50,7,50,50,50,50,50,50,50,50,50,50,50,50,50,50,50,50,50,50,50,50,50,50,50,50,50,50,50,50,50,50,50,50,50,50,50,50,50,50,50,0,1,2,50,50,50,50,50,50,50,50,50,50,50,50,50,50,50,50,50,50,50,50,50,50,50,50,50,50,50,50,50,50,50,50,50,50,50,50,50,50,50,50,50,50,50,50,50,50,50,16,161,161,161,161,161,161,161,161,18,50,50,50,50
50,50,50,50,50,50,50,50,50,50,50,50,50,50,50,50,50,50,50,50,50,50,50,50,50,50,50,50,50,50,50,50,50,50,50,50,50,50,50,50,50,50,50,50,50,50,50,50,50,50,50,50,50,50,50,50,50,50,50,50,50,50,50,50,16,161,49,2,50,50,50,50,50,50,50,50,50,50,50,50,50,50,50,50,50,50,50,50,50,50,50,50,50,50,50,50,50,50,50,50,50,50,50,50,50,50,50,50,50,50,50,50,50,50,32,33,33,33,33,33,64,161,161,18,50,50,50,50
50,50,50,50,50,50,50,50,50,50,50,51,52,53,50,50,50,50,50,50,50,50,1,2,50,50,50,50,50,50,50,50,50,50,50,50,50,50,50,50,50,50,50,50,50,50,50,50,50,0,1,1,1,1,1,1,1,1,1,1,1,1,1,1,48,161,161,18,50,50,50,50,50,50,50,50,50,50,50,50,50,50,50,50,50,50,50,50,50,50,50,50,50,50,50,50,50,50,50,50,50,50,50,50,50,50,50,50,50,50,50,50,50,50,50,50,50,50,50,50,16,161,161,18,50,50,50,50
50,50,50,13,13,13,29,29,29,13,13,67,68,69,13,13,13,13,13,13,13,13,145,49,1,2,50,50,50,50,50,50,50,50,50,50,50,50,50,50,50,50,50,50,50,50,50,50,50,16,161,161,161,161,161,161,161,161,161,161,161,161,161,161,161,161,161,18,50,50,50,50,50,50,50,50,50,50,50,50,50,50,50,50,50,50,50,50,50,50,50,50,50,50,50,50,50,50,50,50,50,50,50,50,50,50,50,50,50,50,50,50,50,50,50,50,50,50,50,50,16,161,161,18,50,50,50,50
50,50,50,29,29,29,45,45,45,29,29,83,84,85,29,29,29,29,29,29,29,29,17,145,145,49,1,2,50,50,50,50,50,50,50,50,50,50,50,50,50,50,50,50,50,50,50,50,50,16,161,161,161,161,161,161,161,161,161,161,161,161,161,161,161,161,161,18,50,50,50,50,50,50,50,50,50,50,50,50,50,50,50,50,50,50,50,50,50,50,50,50,50,50,50,50,50,50,50,50,50,50,50,50,50,50,50,50,50,50,50,50,50,50,50,50,50,50,50,50,16,161,161,18,50,50,50,50
50,50,24,45,45,45,45,45,45,45,45,99,100,101,45,45,45,45,45,45,45,45,17,17,17,145,145,49,1,1,1,2,50,50,50,50,50,50,50,50,50,50,50,50,50,50,50,50,50,32,33,64,161,161,161,65,33,33,33,33,33,33,33,33,64,161,161,18,50,50,50,50,50,50,50,50,50,50,50,50,50,50,50,50,50,50,50,50,50,50,50,50,50,50,50,50,50,50,50,50,50,50,50,50,50,50,50,50,50,50,50,50,50,50,50,50,50,50,50,50,16,161,161,18,50,50,50,50
50,50,24,144,144,144,144,144,144,144,144,161,161,161,161,161,161,161,161,161,161,161,17,17,17,17,17,145,145,145,145,49,1,1,1,1,2,50,50,50,50,50,50,50,50,50,50,50,0,1,1,48,161,161,161,49,1,2,50,50,50,50,50,50,16,161,161,18,50,50,50,50,50,50,50,50,50,50,50,50,50,50,50,50,50,50,50,50,50,50,50,50,50,50,50,50,50,50,50,50,50,50,50,50,50,50,50,50,50,50,50,50,50,50,50,50,50,50,50,50,16,161,161,18,50,50,50,50
50,50,24,144,144,144,161,161,144,144,144,144,144,144,144,144,144,144,144,144,144,161,161,161,161,161,161,161,161,161,161,161,161,161,161,161,18,50,50,50,50,50,50,50,50,50,50,50,16,161,161,161,161,161,161,161,161,18,50,50,50,50,50,50,16,161,161,18,50,50,50,50,50,50,50,50,50,50,50,50,50,50,50,50,50,50,50,50,50,50,50,50,50,50,50,50,50,50,50,50,50,50,50,50,50,50,50,50,50,50,50,50,50,50,50,50,50,50,50,50,16,161,161,18,50,50,50,50
50,50,24,144,144,144,161,161,161,144,144,144,144,144,144,144,161,161,144,144,161,161,161,161,161,161,161,161,161,161,161,161,161,161,161,161,18,50,50,50,50,50,50,50,50,50,50,50,16,161,65,33,33,33,33,64,161,18,50,50,50,50,50,50,16,161,161,18,50,50,50,50,50,50,50,50,50,50,50,50,50,50,50,50,50,50,50,50,50,50,50,50,50,50,50,50,50,50,50,50,50,50,50,50,50,50,50,50,50,50,50,50,50,50,50,50,50,50,50,50,16,161,161,18,50,50,50,50
50,50,24,144,144,144,161,161,161,161,161,144,144,144,144,161,161,161,144,144,161,65,33,33,33,33,33,33,33,33,33,33,33,64,161,161,18,50,50,50,50,50,50,50,50,50,50,50,16,161,18,50,50,50,50,16,161,18,50,50,50,50,50,50,16,161,161,18,50,50,50,50,50,50,50,0,1,1,1,1,1,1,1,1,1,1,1,1,1,1,1,1,1,1,2,50,0,1,1,1,1,1,1,1,1,1,1,1,1,1,1,1,1,1,1,1,1,1,1,1,48,161,161,18,50,50,50,50
50,50,24,144,144,144,161,161,144,144,161,161,161,161,161,161,161,161,144,144,161,18,50,50,50,50,50,50,50,50,50,50,50,16,161,161,18,50,50,50,50,50,50,50,50,50,50,50,16,161,18,50,50,50,50,16,161,18,50,50,50,50,50,50,16,161,161,18,50,50,50,50,50,50,50,16,161,161,161,161,161,161,161,161,161,161,161,161,161,161,161,161,161,161,18,50,16,161,161,161,161,161,161,161,161,161,161,161,161,161,161,161,161,161,161,161,161,161,161,161,161,161,161,18,50,50,50,50
50,50,24,144,144,144,161,161,144,144,144,144,161,161,161,161,161,161,144,144,161,18,50,50,50,50,50,50,50,50,50,50,50,16,161,161,18,50,50,50,50,50,50,50,50,50,50,50,16,161,18,50,50,50,50,16,161,18,50,50,50,50,50,50,16,161,161,18,50,50,50,50,50,50,50,16,161,161,161,161,161,161,161,161,161,161,161,161,161,161,161,161,161,161,18,50,16,161,161,161,161,161,161,161,161,161,161,161,161,161,161,161,161,161,161,161,161,161,161,161,161,161,161,18,50,50,50,50
50,50,24,144,144,144,161,161,161,161,144,144,161,161,161,161,161,161,144,144,161,18,50,50,50,50,50,50,50,50,50,50,50,16,161,161,18,50,50,50,50,50,50,50,50,50,50,50,16,161,18,50,50,50,50,16,161,18,50,50,50,50,50,50,16,161,161,18,50,50,50,50,50,50,50,16,161,161,65,33,33,33,33,33,33,33,64,161,161,144,144,144,161,65,34,50,32,33,33,33,33,33,33,64,161,161,65,33,33,33,33,33,33,64,161,161,65,33,33,33,33,33,33,34,50,50,50,50
50,50,24,144,144,144,161,161,161,161,161,161,161,161,161,161,161,161,144,144,161,18,50,50,50,50,50,50,50,50,50,50,50,16,161,161,18,50,50,0,1,1,1,1,2,50,50,50,16,161,18,50,50,50,50,16,161,18,50,50,50,50,50,50,16,161,161,18,50,50,50,50,50,50,50,16,161,161,18,50,50,50,50,50,50,50,16,161,161,116,144,161,161,49,1,1,1,1,1,1,1,1,1,48,161,161,49,1,1,1,1,1,1,48,161,161,49,1,1,1,1,1,2,50,0,2,50,50
50,50,24,144,144,144,161,161,161,161,161,161,161,161,161,161,161,144,144,144,161,18,50,50,50,50,50,50,50,50,50,50,50,16,161,161,49,2,50,16,161,161,161,161,18,50,50,50,16,161,18,50,50,50,50,16,161,18,50,50,50,50,50,50,16,161,161,18,50,50,50,50,50,50,50,16,161,161,18,50,50,50,50,50,50,50,16,161,161,161,161,161,161,161,161,161,161,161,161,161,161,161,161,161,161,161,161,161,161,161,161,161,161,161,161,161,161,161,161,161,161,161,18,50,32,34,50,50
50,50,24,144,144,144,144,144,144,144,144,144,144,161,161,161,144,144,144,144,161,18,50,50,50,50,50,50,50,50,50,50,50,16,161,161,161,18,50,16,161,161,161,161,18,50,50,50,16,161,18,50,50,50,50,16,161,18,50,50,50,50,50,50,16,161,161,18,50,50,50,50,50,50,50,16,161,161,18,50,50,50,50,50,50,0,48,161,161,161,161,161,161,161,161,161,161,161,161,161,161,161,161,161,161,161,161,161,161,161,161,161,161,161,161,161,161,161,161,161,161,161,18,50,50,50,50,50
50,50,40,144,144,144,161,144,144,144,144,144,144,144,144,144,144,144,144,144,161,18,50,50,50,50,50,50,50,50,50,50,50,32,64,161,161,18,50,16,161,161,161,161,18,50,50,50,16,161,18,50,50,50,0,48,161,18,50,50,50,50,50,50,16,161,161,18,50,50,50,50,50,50,50,16,161,161,18,50,50,50,50,50,50,16,161,161,161,161,161,65,33,33,33,33,33,33,33,33,33,33,33,33,33,33,33,33,33,33,33,33,64,161,161,161,161,161,161,161,161,161,18,50,50,50,50,50
50,50,40,144,144,144,144,144,144,144,144,144,144,144,144,144,144,144,144,144,161,18,50,50,50,50,50,50,50,50,50,50,50,50,16,161,161,18,50,16,161,161,161,161,18,50,50,50,16,161,49,1,1,1,48,161,161,18,50,50,50,50,50,50,16,161,161,18,50,50,50,50,50,50,50,16,161,161,18,50,50,50,50,50,50,16,161,161,161,161,161,18,50,50,50,50,50,50,50,50,50,50,50,50,50,50,50,50,50,50,50,50,32,33,33,33,64,161,161,161,161,161,18,50,50,50,50,50
50,50,40,33,33,64,161,65,33,33,33,33,33,33,33,33,64,144,144,144,161,18,50,50,50,50,50,50,50,50,50,50,50,50,16,161,161,18,50,16,161,161,161,161,18,50,50,50,16,161,161,161,161,161,161,161,161,18,50,50,50,50,50,50,16,161,161,49,1,1,1,1,1,1,1,48,161,161,18,50,50,50,50,50,50,16,161,161,161,161,161,18,50,50,50,50,50,50,50,50,50,50,50,50,50,50,50,50,50,50,50,50,50,50,50,0,48,161,161,161,161,161,18,50,50,50,50,50
50,50,40,50,50,16,161,18,50,50,50,50,50,50,50,50,50,33,33,33,33,34,50,50,50,50,50,50,50,50,50,50,50,50,16,161,161,18,50,16,161,161,161,161,18,50,50,50,32,33,33,64,161,161,65,33,33,34,50,50,50,50,50,50,16,161,161,161,161,161,161,161,161,161,161,161,161,161,18,50,50,50,50,50,50,16,161,161,161,161,161,49,1,1,1,1,1,1,1,1,1,1,1,1,1,1,1,1,1,1,1,1,1,1,1,48,161,161,161,161,161,161,18,50,50,50,50,50
50,50,40,50,50,16,161,49,1,1,1,1,1,1,1,1,1,1,1,1,1,2,50,50,50,50,50,50,50,50,50,50,50,50,16,161,161,18,50,16,161,161,161,161,18,50,50,50,50,50,50,16,161,161,18,50,50,50,50,50,50,50,50,50,16,161,161,161,161,161,161,161,161,161,161,161,161,161,18,50,50,50,50,50,50,16,161,161,161,161,161,161,161,161,161,161,161,161,161,161,161,161,161,161,161,161,161,161,161,161,161,161,161,161,161,161,161,161,161,161,161,161,18,50,50,50,50,50
50,50,40,50,50,16,145,145,145,145,145,145,145,145,145,145,145,145,145,145,145,18,50,50,50,50,50,50,50,50,50,50,50,50,16,161,161,18,50,32,64,161,161,65,34,50,50,50,50,50,0,48,161,161,49,2,50,50,50,50,50,50,50,50,32,33,33,33,33,33,33,33,33,33,33,33,33,33,34,50,50,50,50,50,50,32,64,161,161,161,161,161,161,161,161,161,161,161,161,161,161,161,161,161,161,161,161,161,161,161,161,161,161,161,161,161,161,161,161,161,161,161,18,50,50,50,50,50
50,50,40,50,50,32,33,33,33,33,33,33,33,33,33,33,33,33,33,33,33,34,50,50,50,50,50,50,50,50,50,50,50,50,16,161,161,49,1,1,48,161,161,49,1,1,1,1,1,1,48,161,161,161,161,18,50,50,50,50,50,50,50,50,50,50,50,50,50,50,50,50,50,50,50,50,50,50,50,50,50,50,50,50,50,50,16,161,161,161,161,161,161,161,161,161,161,161,161,161,161,161,161,161,161,161,161,161,161,161,161,161,161,161,161,161,161,161,161,161,161,161,18,50,50,50,50,50
50,50,40,50,50,50,50,50,50,50,50,50,50,50,50,50,50,50,50,50,50,50,50,50,50,50,50,50,50,50,50,50,50,50,16,161,161,161,161,161,161,161,161,161,161,161,161,161,161,161,161,161,161,161,161,18,50,50,50,50,50,50,50,50,50,50,50,50,50,50,50,50,50,50,50,50,50,50,50,50,50,50,50,50,50,50,32,33,33,33,33,33,33,33,33,33,33,33,33,33,33,33,33,33,33,33,33,33,33,33,33,33,33,33,33,33,33,33,33,33,33,33,34,50,50,50,50,50
50,50,40,50,50,50,50,50,50,50,50,50,50,50,50,50,50,50,50,50,50,50,50,50,50,50,50,50,50,50,50,50,50,50,16,161,161,161,161,161,161,161,161,161,161,161,161,161,161,161,161,161,161,161,161,18,50,50,50,50,50,50,50,50,50,50,50,50,50,50,50,50,50,50,50,50,50,50,50,50,50,50,50,50,50,50,50,50,50,50,50,50,50,50,50,50,50,50,50,50,50,50,50,50,50,50,50,50,50,50,50,50,50,50,50,50,50,50,50,50,50,50,50,50,50,50,50,50
50,50,40,50,50,50,50,50,50,50,50,50,50,50,50,50,50,50,50,50,50,50,50,50,50,50,50,50,50,50,50,50,50,50,32,33,33,33,33,33,33,33,33,33,33,33,33,33,33,33,64,161,161,161,161,18,50,50,50,50,50,50,50,50,50,50,50,50,50,50,50,50,50,50,50,50,50,50,50,50,50,50,50,50,50,50,50,50,50,50,50,50,50,50,50,50,50,50,50,50,50,50,50,50,50,50,50,50,50,50,50,50,50,50,50,50,50,50,50,50,50,50,50,50,50,50,50,50
